D-++----+-+----
-+--++----+-+-+
---+--+-+--+---
---+--+-+--+--+
-+---+-+--+-+--
-+-+-+---+----+
+---+--+--++---
--+---+---++--+
-+--+-++-+-----
+----+--------+
+-+--+--+-+----
---+-+---+---+-
-++----+---+--+
-+----+--+--+--
-+--+----+-+--A